5
######
#Aa.@#
#a...#
#Bb..#
#@@..#
######
